12
1,7,5,5,5,6,3,5,5,6,3,6
2,10,1,5,6,10,9,7,7,12,10,10
11,15,7,5,15,13,4,9,13,5,13,14
10,8,11,6,11,7,5,5,7,7,6,10
9,6,11,15,15,12,3,6,11,14,11,14
2,9,14,8,10,3,14,10,9,14,10,10
11,7,14,3,14,9,12,11,6,10,10,10
10,8,11,15,15,7,7,13,15,12,11,14
11,6,11,12,10,8,10,2,11,7,15,14
11,15,15,6,11,7,15,15,15,14,8,10
10,9,15,13,13,13,12,10,9,13,5,12
8,1,12,1,5,5,5,13,5,5,5,4